...#....
.......#
.......O
..#....O
......#O