O..#....
.......#
........
..#....O
.....O#.